11111111
1P101001
1C001111
10100011
100E01C1
101C1111
11111111
